5 10 517 11
48 220 107 95 63 42 113 214 161 104
158 50 197 34 82 207 135 41 165 44
48 201 86 218 47 49 57 174 129 176
88 137 154 34 95 135 33 100 193 183
176 132 187 117 214 158 87 129 115 180
1 8 2
3 8 3
3 3 3
3 6 1
2 4 3
2 5 2
2 3 2
1 6 1
2 3 2
2 7 3
3 5 1
